##########
####   # #
##E     ##
#     # ##
#    ##  #
#  #     #
# S      #
#  #   # #
#        #
##########
