####################
##           #  #  #
# #  #  #  ## ##   #
# ##    E#     #   #
# # # #    #  ##  ##
#            # #   #
# ##      # #   # ##
#   # #    # ##    #
#    # #    #      #
##     #    #    # #
###  #         # # #
## #        ## # # #
#  # # #      #    #
#       S      #   #
####   # #  #      #
#      #  #    ##  #
# ##     #     #  ##
#  ##   ### ## #   #
# ##    # ##   #   #
####################
