##########
#E       #
#   # # ##
#  ##    #
#   # ## #
#     #  #
##  S  # #
#  #  # ##
## ### # #
##########
