##########
###E   ###
#   ##   #
# ####   #
#  ### ###
# ####   #
###    ###
#S     # #
#        #
##########