##########
#    E   #
# # # #  #
### # # ##
#       ##
# #####  #
# #      #
# # # ## #
#S       #
##########