##########
###    ###
#    E   #
#        #
#  #### ##
# ####   #
# #    ###
#   S    #
#        #
##########