##########
###    ###
#    E   #
#        #
# ### # ##
#        #
# # #### #
#   S    #
#        #
##########