##########
###    ###
#    E   #
#        #
#  #### ##
# ####   #
# #S # ###
#    #  ##
####     #
##########